^________________________~E
|                        !E
|                        !E
|                        !E
|                        !E
|                        !E
|                        !E
|                        !E
|                        !E
|                        !E
|                        !E
|                        !E
|                        !E
|                        !E
|                        !E
|                        !E
|                        !E
|                        !E
|                        !E
<---------}  {----------->E
          |  !E
          |  !E
          |  !E
          |  !E
          |  !E